03,03,03,03,03,03,03,03,03,03,03,03,03,03,03,03,03,03,50,50,50,50,50,50,50,50,50,50,50,50,50,50,50,50,50,50,50,50,50,50,50,50,50,50,50
03,03,03,03,03,03,03,03,03,03,03,03,03,03,03,03,03,03,14,50,50,17,50,50,50,50,50,50,50,50,50,50,50,50,50,50,50,50,50,50,50,50,50,50,50
03,03,03,03,03,03,03,03,10,00,00,00,00,03,03,03,10,00,00,03,03,00,00,32,50,50,50,50,50,50,50,50,50,50,50,50,50,50,50,50,50,50,50,50,50
03,03,03,03,03,03,03,10,00,00,00,00,00,00,03,10,03,03,03,03,03,03,03,03,32,50,50,50,50,50,50,50,50,50,50,50,50,50,50,50,50,50,50,50,50
03,03,03,03,03,03,10,00,00,00,00,00,00,00,00,03,03,03,03,03,03,03,03,03,03,32,50,50,50,50,50,50,50,50,50,50,50,50,50,50,50,50,50,50,50
03,03,03,03,03,10,00,00,03,03,03,00,00,00,00,03,03,03,03,03,03,03,03,03,03,03,32,50,50,50,50,50,50,50,50,50,50,50,50,50,50,50,50,50,50
19,22,03,03,08,39,03,03,03,03,03,00,00,00,00,01,03,01,01,03,03,01,03,01,03,01,03,32,50,50,50,50,50,50,50,50,50,50,50,50,50,50,50,50,50
26,05,03,03,03,03,03,03,03,09,07,00,00,00,00,48,49,48,03,48,48,49,48,49,48,49,48,48,32,50,50,50,50,50,50,50,50,50,50,50,50,50,50,50,50
26,05,08,07,03,03,03,03,03,03,03,00,00,00,00,09,09,09,09,09,09,09,09,09,09,09,09,09,09,09,50,50,50,50,50,50,50,50,50,50,50,50,50,50,50
27,20,03,03,03,03,03,03,03,03,03,00,00,00,00,50,50,50,50,50,50,50,50,50,50,50,50,50,50,50,50,50,50,50,50,50,50,50,50,50,50,50,50,50,50
24,03,03,03,03,08,09,07,03,03,03,00,00,00,00,50,50,50,50,50,50,50,50,50,50,50,50,50,50,50,50,50,50,50,50,50,50,50,50,50,50,50,50,50,50
26,03,03,03,03,03,03,03,03,03,03,00,00,00,00,50,50,50,50,50,50,50,50,50,50,50,50,50,50,50,50,50,50,50,50,50,50,50,50,50,50,50,50,50,50
26,00,09,07,03,03,03,03,03,03,03,00,00,00,00,50,50,50,50,50,50,50,50,50,50,50,50,50,50,50,50,50,50,50,50,50,50,50,50,50,50,50,50,50,50
26,13,48,03,03,03,03,03,03,08,09,09,09,09,09,36,03,50,50,50,50,50,50,50,50,50,50,50,50,50,50,50,50,50,50,50,50,50,50,50,50,50,50,50,50
26,13,05,03,03,03,03,03,03,03,03,50,50,50,50,50,03,50,50,50,50,50,50,50,50,50,50,50,50,50,50,50,50,50,50,50,50,50,50,50,50,50,50,50,50
27,13,20,03,03,03,03,03,03,03,03,50,50,50,50,50,50,50,50,50,50,50,50,50,50,50,50,50,50,50,50,50,50,50,50,50,50,50,50,50,50,50,50,50,50
03,03,03,03,03,03,08,09,07,03,03,50,50,50,50,50,50,50,50,50,50,50,50,50,50,50,50,50,50,50,50,50,50,50,50,50,50,50,50,50,50,50,50,50,50
03,03,03,03,03,03,03,03,03,03,03,50,50,50,50,50,50,50,50,50,50,50,50,50,50,50,50,50,50,50,50,50,50,50,50,50,50,50,50,50,50,50,50,50,50
03,03,03,08,09,03,03,03,03,03,03,03,50,50,50,50,50,50,50,50,50,50,50,50,50,50,50,50,50,50,50,50,50,50,50,50,50,50,50,50,50,50,50,50,50
03,03,03,03,03,03,03,03,03,03,03,03,50,50,50,50,50,50,50,50,50,50,50,50,50,50,50,50,50,50,50,50,50,50,50,50,50,50,50,50,50,50,50,50,50
00,00,01,01,01,01,01,01,01,01,01,01,50,50,50,50,50,50,50,50,50,50,50,50,50,50,50,50,50,50,50,50,50,50,50,50,50,50,50,50,50,50,50,50,50
